2 1 1 2 1 2 1 1 1 1 6 6 1 2 1
2 2 1 1 1 1 2 1 1 1 6 6 2 1 1
1 1 1 1 1 2 1 6 1 6 6 6 6 1 2
1 2 1 1 1 1 2 1 1 1 1 6 1 6 6
3 1 1 2 1 1 1 2 1 1 2 1 6 6 6
3 3 1 2 2 1 1 1 1 1 1 1 1 6 1
3 3 3 1 1 1 1 1 1 1 2 1 1 1 1
3 3 2 1 2 1 2 2 4 1 4 1 1 1 1
4 4 4 4 5 1 4 4 4 1 4 4 2 1 1
1 1 1 4 4 4 4 2 1 1 1 4 4 2 1
1 1 1 2 1 4 4 1 1 2 1 1 4 4 4
6 1 6 1 4 4 1 2 1 1 2 2 1 1 2
1 1 1 1 1 1 1 1 2 2 1 1 1 2 1
2 1 1 4 4 1 1 1 1 1 2 2 1 2 1
1 1 4 4 1 2 1 1 1 2 1 1 2 1 2
